WWWWWWWW
W      W
W  B   W
W  B   W
W BW  SW
W PWS SW
WWWWWWWW