WWWWWWWWWWWW
WW   P   WWW
WW B B   SWW
WS B B B SSW
WW B B S SWW
WW      SWWW
WWWWWWWWWWWW