WWWWWWWWWWWWWW
W     PW     W
W WWWWWW B  BW
W     BS     W
WWWWWWWWWWWS W
WWWWWWWWWWWWSW
WWWWWWWWWWWWWW