WWWWWWWWW
WS  WS  W
WBB W   W
W W W WBW
W W W W W
W W W W W
W W B W W
WPWS  WSW
WWWWWWWWW